   # # # # # # # # # # # 
   # . . . # . . . . / # 
   # . # . # # # # # . # 
   # . # . . . # . . . # 
   # # # . # . # . # # # 
   # . . . # . . . . . # 
   # . # # # # # . # # # 
   # . . . # . . . . . # 
   # . # . # . # . # . # 
   # / # . # . # . # . # 
   # # # # # # # # # # # 
